# # # # # # # # # # # # # # # # # # # # # # # # # # # # # # # 
#   #                       #                   #           ee
#   #   # # # # # # # # #   #   # # # # #   #   # # # # #   # 
#   #       #   #           #   #           #               # 
#   # # #   #   #   # # # # # # #   # # # # # # # # # # # # # 
# cc        #   #               #   #           #           # 
# # # # # # #   # # # # # # #   #   #   # # #   #   #   # # # 
#               #               #           #       #       # 
#   # # # # # # #   # # # # # # # # # # # # # # # # # # #   # 
#                   #       #               #               # 
#   # # # # # # # # #   #   #   #   # # #   #   # # # # # # # 
#               #       #   #   #   #       #   #     cc#   # 
# # # # # # #   # # #   #   #   #   #   # # #   #   # # #   # 
#   #       #           #   #   #   #           #   #       # 
#   #   #   # # # # # # #   # # #   # # # # # # #   #   # # # 
#       #               #       #   #                   #   # 
#   # # # # # # #   # # # # #   #   #   # # # # # # # # #   # 
#   #           #   #       #   #   #                   #   # 
#   #   # # #   #   #   #   #   #   # # # # # # # # #   # # # 
#       #       #       #           #                       # 
# # # # # # # # # # # # # # # # # # # # # # # # # # # # # # # 